11111111111111111111111111111111
1   1    y     p  1     y    p 1
1 p 11111111111   1 111111111111
1   1          p  1 1        p 1
1   1 x           1 1 1111111111
1   11111111111   1 1        1p1
1   1 p1p 1 p1    1 1 11111111 1
1   1  1  1x 1  y 1 1   p1 1 1 1
1      x  1  1           1 1 1y1
1 y 1111111  1111   111111 p 1 1
1               x            1 1
1    1    1  111111 1111111111 1
111111 y  1  1      1          1
1  p 1    1  1  p   11111 111111
1    1    1  1               1p1
1    1    11111111 11111111111 1
1  a              z            1
11111111111111111111111111111111